[{
		"map": [
			"wwwwwwwwwwwwwwwwwwww",
			"ws-----------------w",
			"w------------------w",
			"w------------i-----w",
			"w------------------w",
			"w------------g-----w",
			"w------------------w",
			"w------------------w",
			"w------------------w",
			"w------------------w",
			"w--------w---------w",
			"w--------w---------w",
			"w--------w---------w",
			"w--------w---------w",
			"w------------------w",
			"w------------------w",
			"w------------------w",
			"w------------------w",
			"w------------------w",
			"wwwwwwwwwwwwwwwwwwww"
		],
		"data": {
			"name": "test",
			"ctfData": [{
				"x": 160,
				"y": 130
			}, {
				"x": 300,
				"y": 400
			}]
		}
	},
	{
		"map": [
			"wwwwwwwwwwwwwwwwwwwwwwwwwwwwwwwwwwwwwwww",
			"ws------------------------------------iw",
			"w------w-------------------------------w",
			"w-----ww-------------------------------w",
			"wwwwwww---------------w----------------w",
			"w---------------------ws------g--------w",
			"w---------------wwwwwwwwwwwwwwwww------w",
			"w--------------------------sw----------w",
			"w---------------------------w----------w",
			"w---------------------------w----------w",
			"w--------ii-----------------w----------w",
			"w--------------------------------------w",
			"w----------------------------s---------w",
			"w-----------w--------------wwwwwww-----w",
			"w-----------w--------------------------w",
			"w----------sws-------------------------w",
			"w-------wwwwwwwww------------i---------w",
			"w--------------------------------------w",
			"w--------------------------------------w",
			"w--------------------------------------w",
			"w--------------------------------------w",
			"w-------------------w---g--------------w",
			"w-----i---------g----------------------w",
			"w--------------------------------------w",
			"w--------------------------------------w",
			"w--------------wwwwwwwwwwwwwwwwwww-----w",
			"w-------------------sws----------------w",
			"w--------------------w-----------------w",
			"w--------------------w-----------------w",
			"w--------------------w-----------------w",
			"w--------------------------------------w",
			"w----------wwwwwwww----------g---------w",
			"w--------------------------------------w",
			"w-------------w------------------------w",
			"w------------sw-----------wwwwww-------w",
			"w------wwwwwwwww-----------------------w",
			"w--------------------------------------w",
			"w-------------------------------wwwwwwww",
			"ws------ii----------------------------sw",
			"wwwwwwwwwwwwwwwwwwwwwwwwwwwwwwwwwwwwwwww"
		],
		"data": {
			"name": "yeet",
			"ctfData": [{
				"x": 160,
				"y": 130
			}, {
				"x": 300,
				"y": 400
			}]
		}
	},
	{
		"map": [
			"wwwwwwwwwwwwwwwwwwwwwwwwwwwwwwwwwwwwwwww",
			"w-s--------swg------w------------------w",
			"w-----------w-------ws----------------sw",
			"w-----------w-------w-----------------w-",
			"w----g-i----w------iwg-----------------w",
			"www--www--wwwwwwwwwwwi-----------------w",
			"w------------------------------------igw",
			"w-----------------------------------wwww",
			"ws----------------------------------wwww",
			"wwww--------------wwww-wwww----------www",
			"---ww-------------h-------ww-----------w",
			"----ww------------hi------gh-----------w",
			"---ww-------------ww-------h-----------w",
			"wwww---------------www-wwwww-----------w",
			"w--------------------h-w---------------w",
			"w--------------------w-h---------------w",
			"w--------------wwwwwww-wwwwww--w-------w",
			"w------------------------------w-------w",
			"w-------w--wwwww---------------w-------w",
			"w-------w----igwi--------h---s-w-------w",
			"w-------w------wg--------h-----w-------w",
			"w-------ws-----wwwww----wwwwwwww-------w",
			"wwww----wwww---w------------wgiw------sw",
			"ws------hhhh---w-----------sw--w----wwww",
			"w-------hhhh---w------------w--w-------w",
			"w-------hhhh---w---------------w-------w",
			"w-------hhhh---w-s-------------w-------w",
			"w-------hhhh---wwwwwwww-wwwwwwww-------w",
			"w-------------------------------------ww",
			"w------------------------------------w-w",
			"wwwwwwwww---------------------------wisw",
			"--------w-------w-wwhhhhwwwwhhww---wg--w",
			"--------w-------w--w----g--w---w-------w",
			"--------ws------w-----wi-----sw-------w",
			"--------w-------wwwwwwwwwwwwwwww-------w",
			"wwwwwwwww-------------s----------------w",
			"w--------------------------------------w",
			"ws-------------------------------------w",
			"wgi-----------------------------------sw",
			"wwwwwwwwwwwwwwwwwwwwwwwwwwwwwwwwwwwwwwww"
		],
		"data": {
			"name": "NukeT",
			"ctfData": [{
				"x": 160,
				"y": 130
			}, {
				"x": 300,
				"y": 400
			}]
		}
	}
]
